##########################################
#                                        #
#           ####                         #
#                                        #
#                                        #
#                                ####    #
#                                        #
#                                        #
#                                        #
#                                        #
#    ####         ooo<                   #
#                                        #
#                                        #
#                                        #
#                          ####          #
##########################################
